XXXXXXXXXXXXXXXXXXXXXXXX
X13a21111111132b1111111X
XXXXXXXX1111X2111132133X
X1111111111112312211111X
XXXXXXXXXX2311123222111X
X1111111111111111111111X
X3311111232312311211111X
XXXXXXXXXXXXXXXXXXX1322X
X111111233X232123111113X
X12312232X3222X11111111X
X2311112X32323X11111132X
Xc12231X21111dX1111333eX
XXXXXXXXXXXXXXXXXXXXXXXX